#######################################
#_!__!_?_______________________!__B___#
#__________!_!________________________#
#_____________________________________#
#_____________________________________#
#_____________________________________#
#__!_!___#______________!_____________#
#________#_____!______________________#
#___?____#__________________________!_#
#________#_____________________##############################
##########___#########______________________________________#
##########_!_#########_________________________________!__?_#
##########___#########__________________________________!___#
##########__________________________________________________#
##########______!__!___________________________________!____#
#____________################################################
#__A_?_?_B___################################################
#____________################################################
#############################################################