#########################
#_A____________R________#
#___R___?_?_?________####
#____________________#!_#
#__________B_________####
#########################